0,0,0,6;
0,6,6,6;
0,0,6,0;
6,0,6,6;
0,2,1,2;
1,2,1,3;
1,1,2,1;
2,1,2,4;
1,4,2,4;
2,2,6,2;
3,0,3,1;
3,1,5,1;
1,5,3,5;
3,3,3,6;
4,4,4,5;
4,5,5,5;
5,3,5,5;